100258	0
100259	0
100260	0
100261	0
100262	0
100263	0
