100169	0
100170	0
100171	0
100172	0
100173	0
100174	0
100175	0
100176	0
100177	0
100178	0
100179	0
100180	0
100181	0
100182	0
