100193	0
100194	0
100195	0
100196	0
100197	0
100198	0
100199	0
100200	0
100201	0
