100301	0
100302	0
100303	0
100304	0
100305	0
100306	0
100307	0
100308	0
100309	0
100310	0
100311	0
100312	0
100313	0
100314	0
100315	0
