100127	0
100128	0
100129	0
100130	0
100131	0
100132	0
100133	0
100134	0
100135	0
100136	0
100137	0
100138	0
100139	0
100140	0
100141	0
100142	0
100143	0
100144	0
100145	0
100146	0
100147	0
100148	0
100149	0
100150	0
100151	0
100152	0
100153	0
100154	0
100155	0
100156	0
100157	0
100158	0
100159	0
100160	0
100161	0
100162	0
100163	0
100164	0
100165	0
100166	0
100167	0
100168	0
