100169	0
100170	0
100171	1
100172	0
100173	0
100174	0
100175	10
100176	0
100177	2
100178	4
100179	0
100180	9
100181	0
100182	0
