100264	0
100265	0
100266	0
100267	2
100268	0
100269	0
100270	0
100271	0
100272	0
100273	0
100274	0
100275	0
100276	0
100277	0
100278	0
100279	0
100280	0
100281	0
100282	0
100283	0
100284	0
100285	0
100286	0
100287	0
100288	0
100289	0
100290	0
100291	0
100292	0
100293	0
100294	0
100295	48
100296	0
100297	102
100298	0
100299	0
100300	0
