100169	0
100170	0
100171	7
100172	0
100173	0
100174	2
100175	26
100176	0
100177	12
100178	25
100179	0
100180	38
100181	0
100182	0
