100209	10
100210	0
100211	0
100212	0
100213	0
100214	20
100215	0
100216	0
100217	0
100218	0
100219	0
100220	0
100221	0
100222	0
100223	0
100224	0
100225	2
100226	0
100227	6
100228	0
100229	0
100230	1
100231	0
100232	1
100233	31
100234	0
100235	0
100236	0
100237	0
100238	0
100239	2
100240	0
100241	1
100242	0
100243	37
100244	0
100245	52
100246	0
100247	0
100248	0
100249	0
100250	1
100251	2
100252	0
100253	0
100254	4
100255	0
100256	1
100257	0
